R 800 400
S ./sponge.png
C 225,30,0
F 225,30,0
1 1 1 1 1 1
1 0 0 0 0 1
1 0 0 0 0 1
1 0 0 0 N 1
1 1 1 1 1 1